απουσία	απουσία noun f (plural απουσίες)<br>absence
φιλοσοφία	φιλοσοφία noun f (plural φιλοσοφίες)<br>philosophy (science and belief system)
αγαπητός	αγαπητός adjective<br>dear<br>likable, lovable
οικονομικός	οικονομικός adjective<br>economic, financial, fiscal<br>thrifty, economical
επιτέλους	επιτέλους adverb<br>at last, finally
μέτωπο	μέτωπο noun n (plural μέτωπα)<br>forehead<br>(meteorology) front (weather front)<br>(military) front line
αποδέχομαι	αποδέχομαι verb<br>admit, demonstrate
λεφτά	λεφτά noun n<br>money, cash<br>wealth, financial estate<br><br>λεφτά noun m
αντίστοιχα	αντίστοιχα adverb<br>respectively<br>correspondingly
δείκτης	δείκτης noun m (plural δείκτες)<br>indicator, quotient, measure (something indicating a value)<br>index finger, forefinger<br>pointer of an instrument<br>subscript
έξοδος	έξοδος noun f (plural έξοδοι)<br>exit, way out
αμυντικός	αμυντικός adjective<br>defensive<br>(as a noun) defender
επεισόδιο	επεισόδιο noun n (plural επεισόδια)<br>incident, event<br>(television) episode<br>(theater) scene<br>(medicine) attack, episode
ήρωας	ήρωας noun m (plural ήρωες, feminine ηρωίδα)<br>hero (courageous person; chief character in drama, book, etc)
μελετώ	μελετώ verb<br>study<br>practise (UK), practice (US)<br>contemplate, deliberate
σεβασμός	σεβασμός noun m (plural σεβασμοί)<br>respect
διά	διά preposition<br>by, for
πλησιάζω	πλησιάζω verb<br>(transitive) approach, bring, move closer<br>(intransitive) approach (to bribe or persuade)<br>(intransitive) approach (for sexual purposes)
προετοιμασία	προετοιμασία noun f (plural προετοιμασίες)<br>preparation (the act of getting ready)
περιστατικό	περιστατικό noun n (plural περιστατικά)<br>event, incident<br>(medicine) case
σεζόν	σεζόν noun f<br>season (part of year)
γάλα	γάλα noun n (plural γάλατα)<br>milk
φυλακή	φυλακή noun f (plural φυλακές)<br>prison, jail, gaol<br>imprisonment
πάω	πάω verb<br>go<br>go, attend<br>depart, leave<br>be going to<br>go, elapse (for a time)<br>go<br>go with, have sex with
απειλή	απειλή noun f (plural απειλές)<br>threat
σωματικός	σωματικός adjective<br>physical, bodily, corporal (relating to the body)
πρακτική	πρακτική noun f (plural πρακτικές)<br>practice, experience
κόρη	κόρη noun f (plural κόρες)<br>daughter<br>maiden, girl<br>kore; statue of a young woman<br>pupil (of the eye)
σύντομος	σύντομος adjective<br>short, curtailed (in extent)<br>short, brief, quick (in duration)
διδασκαλία	διδασκαλία noun f (plural διδασκαλίες)<br>teaching, tuition, instruction<br>(by extension) doctrine, teaching
εδώ	εδώ adverb<br>here
αφαιρώ	αφαιρώ verb<br>subtract, reduce, remove<br>deprive<br>(mathematics) subtract
εγκρίνω	εγκρίνω verb<br>approve
κιλό	κιλό noun n (plural κιλά)<br>kilo (kilogram)
πάλη	πάλη noun f (plural πάλες)<br>wrestling<br>fight, struggle
προσωπικότητα	προσωπικότητα noun f (plural προσωπικότητες)<br>character, personality<br>personality (in show business, sport, etc)<br>influential person
δάσος	δάσος noun n (plural δάση)<br>wood, forest
παραμονή	παραμονή noun f<br>abidance, staying, remaining<br>eve
εκείνος	εκείνος pronoun<br>(singular) that<br>(plural) those
φιλικός	φιλικός adjective<br>friendly, amiable<br>informal
μαλλί	μαλλί noun n (plural μαλλιά)<br>wool<br>all the hairs of the head
παντού	παντού adverb<br>everywhere, all over the place (at all places)
μέση	μέση noun f (plural μέσες)<br>middle, midpoint<br>waist, waistband<br><br>μέση adjective
κίνα	κίνα noun f<br>cinchona (South American tree)<br>cinchona bark<br><br>κίνα noun n<br>henna (plant (Lawsonia inermis) and dye)
απόδειξη	απόδειξη noun f (plural αποδείξεις)<br>proof<br>(mainly in plural) evidence<br>receipt
κα	κα initialism<br>Abbreviation of κυρία (kyría): Mrs, Ms
πίνω	πίνω verb<br>drink (water, coffee, beers, etc)<br>toast (drink someone's health)<br>drink (I am a drinker of alcoholic drinks)<br>(colloquial) smoke tobacco, use drugs
απομακρύνω	απομακρύνω verb<br>remove, oust<br>vacate, evacuate, depart<br>remove oneself, distance oneself
ιδρύω	ιδρύω verb<br>found, establish (a city, society, institution)<br>(less common) erect (a building of importance)
κυβέρνηση	κυβέρνηση noun f (plural κυβερνήσεις)<br>government
γαλλικός	γαλλικός adjective<br>French, Gallic
δελτίο	δελτίο noun n (plural δελτία)<br>card, form, document
επάγγελμα	επάγγελμα noun n (plural επαγγέλματα)<br>profession, calling, trade, vocation
τί	τί pronoun<br>Uncommon spelling of τι (ti).
εργάτης	εργάτης noun m (plural εργάτες, feminine εργάτρια)<br>male worker, labourer, hand, servant
χωρίζω	χωρίζω verb<br>separate, divide<br>divorce
εκατοντάδα	εκατοντάδα noun f (plural εκατοντάδες)<br>group of 100
ερμηνεία	ερμηνεία noun f (plural ερμηνείες)<br>interpretation, explanation, make understandable
ύλη	ύλη noun f (plural ύλες)<br>(physics) matter<br>matter, stuff, material, substance
υιοθετώ	υιοθετώ verb<br>adopt (a child)<br>adopt, endorse (an idea or policy)
καταργώ	καταργώ verb<br>abolish, quash, repeal, nullify, negate, annul
σύμπτωμα	σύμπτωμα noun n (plural συμπτώματα)<br>symptom<br>(figuratively) sign
αιγαίο	Aegean
ποδοσφαιριστής	ποδοσφαιριστής noun m (plural ποδοσφαιριστές, feminine ποδοσφαιρίστρια)<br>footballer, football player, soccer player (one who plays soccer)
επτά	επτά numeral<br>(cardinal) seven
κάπως	κάπως adverb<br>somewhat, kinda, a bit<br>somehow, in some way
περίπτωση	περίπτωση noun f (plural περιπτώσεις)<br>case (an actual event, situation, or fact)<br>case (a person being treated for illness or a customer being served in a shop etc)<br>(colloquial, derogatory) oddball, weirdo (a person who behaves strangely)<br>(colloquial) cream of the crop, crème de la crème (an outstanding or excellent case)
μονή	μονή noun f (plural μονές)<br>monastery, nunnery, convent<br><br>μονή adjective
τέταρτος	τέταρτος adjective<br>fourth (the ordinal form of τέσσερα)
τότε	τότε adverb<br>then<br>therefore
αδελφός	αδελφός noun m (plural αδελφοί, feminine αδελφή)<br>brother<br>(religion) monk
εισιτήριο	εισιτήριο noun n (plural εισιτήρια)<br>(transport, theater) ticket for bus, train, etc, or theatre, etc
πάντοτε	πάντοτε adverb<br>always
πετρέλαιο	πετρέλαιο noun n (plural πετρέλαια)<br>petroleum, oil
κοινωνικός	κοινωνικός adjective<br>social<br>sociable, gregarious
αξιοποίηση	αξιοποίηση noun f<br>exploitation<br>development
αέριο	αέριο noun n (plural αέρια)<br>gas<br>(in plural form) wind, flatulence, fart<br><br>αέριο adjective
σημαντικός	σημαντικός adjective<br>important, significant, considerable, outstanding, notable
υπογραμμίζω	υπογραμμίζω verb<br>underline, underscore<br>(figuratively) stress, emphasise
επικοινωνώ	επικοινωνώ verb<br>talk, communicate
γεύση	γεύση noun f (plural γεύσεις)<br>(physiology) taste (sense)<br>taste (sweet, sour, etc)<br>(figuratively) impression (left by someone)<br>(figuratively) impression (sampling of an experience)
δικός	δικός pronoun<br>(followed by possessive pronoun) mine, yours, his, hers, its, ours, theirs<br>(usually preceded by the article and followed by possessive pronoun) my, your, his, her, its, our, their (emphatic form)
κοινοβούλιο	κοινοβούλιο noun n (plural κοινοβούλια)<br>parliament
χαίρω	χαίρω verb<br>be happy, be glad
ένταξη	ένταξη noun f (plural εντάξεις)<br>accession, integration, incorporation
πακέτο	πακέτο noun n<br>package (a physical container)<br>(informatics) package<br>(slang) big disappointment
εισάγω	εισάγω verb<br>(transitive) import (goods from abroad)<br>(transitive) introduce (an educational subject)<br>(transitive) introduce (a new product to the market)<br>(transitive) admit (patient to hospital)<br>(transitive) begin, introduce (grammar: a sentence)
όσος	όσος pronoun<br>as many as, as much as
λίγος	λίγος adjective<br>a little, a few, a bit of
αποκατάσταση	αποκατάσταση noun f (plural αποκαταστάσεις)<br>restoration, reconstruction, renovation (the process or result)<br>restoration (ensure future life or quality of life)<br>rehabilitation
τέλος	τέλος noun n (plural τέλη)<br>end, finish
αποτέλεσμα	αποτέλεσμα noun n (plural αποτελέσματα)<br>result, outcome (sport, election, etc)<br>effect
έρχομαι	έρχομαι verb<br>(most senses) come<br>cost<br>(with σε) come to<br>(with genitive weak pronoun before) suit (go well with)<br>(with genitive weak pronoun before and followed by να) feel like, get the urge (to have a desire for)
έκπληξη	έκπληξη noun f (plural εκπλήξεις)<br>surprise
αγαθό	αγαθό noun n (plural αγαθά)<br>commodity, good<br>possession<br>(in plural form) possessions, wealth<br><br>αγαθό adjective
ορθόδοξος	ορθόδοξος adjective<br>(religion, sometimes other ideologies) Orthodox (relating to any Orthodox movement or ideology; on its own, usually refers to Greek Orthodox in Greek)<br>orthodox (following convention or tradition)<br><br>ορθόδοξος noun m (plural ορθόδοξοι, feminine ορθόδοξη)<br>(Christianity, male) Orthodox (follower of any of the Eastern Orthodox churches)
ούτε	ούτε conjunction<br>neither, nor<br>neither … nor<br>nor even, not even
δεη	ΔΕΗ<br>:argest electric company
αρχή	αρχή noun f (plural αρχές)<br>origin, beginning<br>principle<br>authority<br>government authorities (as plural)
ανέρχομαι	ανέρχομαι verb<br>rise, move up<br>amount
ώρα	ώρα noun f (plural ώρες)<br>hour (1/24 of a day)<br>time (A quantity of availability in time, time of day as indicated by a clock, some specific time, right time, time for something)
έλλειμμα	έλλειμμα noun n (plural ελλείμματα)<br>(finance) deficit
σχέση	σχέση noun f (plural σχέσεις)<br>relationship (personal)<br>relation, connection<br>relationship (between two things)<br>(automotive) gear, ratio (a particular combination or choice of interlocking gears)
προγραμματίζω	προγραμματίζω verb<br>plan, schedule, organise (UK), organize (US)<br>programme (UK), program (US)<br>(computing) program
μαζί	μαζί adverb<br>(place) together, with (takes the genitive case)<br>(time) together, along with, at the same time
κανονισμός	κανονισμός noun m<br>regulation, bylaw
υπογραφή	υπογραφή noun f (plural υπογραφές)<br>signature<br>(figuratively) agreement
πρόοδος	πρόοδος noun f (plural πρόοδοι)<br>progress, moving forward
εμπόριο	εμπόριο noun n<br>trade<br>trafficking
ευρώ	ευρώ noun n<br>(finance) euro (the currency)
πρόγραμμα	πρόγραμμα noun n (plural προγράμματα)<br>schedule (timed plan of events)<br>program (of events)<br>calendar (future events for theatre etc)<br>broadcast
μωρό	μωρό adjective<br><br>μωρό noun n (plural μωρά)<br>baby, infant<br>(colloquial, informal, usually followed by μου) baby (term of address for partner)
αφού	αφού conjunction<br>after (having done something)<br>since
εξαίρεση	εξαίρεση noun f (plural εξαιρέσεις)<br>exception, exemption
διάκριση	διάκριση noun f (plural διακρίσεις)<br>distinction, of note<br>discretion, discrimination
άνοδος	άνοδος noun f (plural άνοδοι)<br>increase, rise<br>route to the top<br>(physics) anode
επιχείρημα	επιχείρημα noun n (plural επιχειρήματα)<br>argument, reasoning (reasons in support of a position)
όγκος	όγκος noun m (plural όγκοι)<br>bulk, volume, mass, heap, weight<br>tumor
συνταγή	συνταγή noun f (plural συνταγές)<br>(medicine) prescription<br>(cooking) recipe
εγκαθιστώ	εγκαθιστώ verb<br>install, put in (equipment, etc)<br>(computing) install (software)
πάνω	πάνω adverb<br>above, on, up, upstairs
πέραν	πέραν adverb<br>beyond<br>(obsolete): Alternative form of πέρα (péra)
καριέρα	καριέρα noun f (plural καριέρες)<br>career
υποχρεώνω	υποχρεώνω verb<br>oblige, force, obligate, compel
πλεονέκτημα	πλεονέκτημα noun n (plural πλεονεκτήματα)<br>profit, gain<br>advantage, boon (something offering the chance of gain)
δις	δις adverb<br>twice<br><br>δις noun f<br>Abbreviation of δεσποινίς (despoinís): Miss, Ms
κύπελλο	κύπελλο noun n (plural κύπελλα)<br>goblet (drinking vessel)<br>trophy cup
λονδίνο	London
ε	ε interjection<br>(colloquial) hey, oi (said to get someone's attention)<br>eh, huh (used as a tag question, emphasising what goes before or to request that the listener express an opinion about what has been said)<br>(colloquial) eh, huh, what, pardon (in isolation, request for repetition or clarification of what has just been said)<br>I wish, if only (expressing a wish or hope)<br>(colloquial) oh, just (to precede an offhand or annoyed remark)<br>(colloquial) oh (expression of wonder, amazement, or awe)<br>(repeatedly and drawn out) um, er (implying hesitation)<br><br>ε letter<br>Lower case epsilon, the fifth letter of the modern Greek alphabets. Its name is presently έψιλον. It represents, in Modern Greek, a somewhat lowered variant of the mid front unrounded vowel: /e/ or /e̞/. It is preceded by δ and followed by ζ.
χιλιόμετρο	χιλιόμετρο noun n (plural χιλιόμετρα)<br>kilometre (UK), kilometer (US)
μύθος	μύθος noun m (plural μύθοι)<br>fable, tale, story, myth, fairy tale
νικάω	νικάω verb<br>Alternative form of νικώ (nikó)
ομορφιά	ομορφιά noun f (plural ομορφιές)<br>beauty
μεσημέρι	μεσημέρι noun n<br>midday
πάρκο	πάρκο noun n (plural πάρκα)<br>park<br>garden
βιβλιοθήκη	βιβλιοθήκη noun f (plural βιβλιοθήκες)<br>library<br>bookcase
δείγμα	δείγμα noun n (plural δείγματα)<br>sample, specimen
φταίω	φταίω verb<br>(intransitive) be to blame, be at fault, be in the wrong<br>(sometimes in past tenses) do wrong, do a misdeed
απορρίπτω	απορρίπτω verb<br>reject, refuse, turn down<br>fail<br>discard, throw out,
παύω	παύω verb<br>stop, cease<br>pause<br>depose, relieve of duties
σύστημα	σύστημα noun n (plural συστήματα)<br>system
σεμινάριο	σεμινάριο noun n<br>seminar
μηχανικός	μηχανικός adjective<br>mechanical, machine<br><br>μηχανικός noun m, f (plural μηχανικοί)<br>(engineering) engineer, mechanic
απόλυση	απόλυση noun f (plural απολύσεις)<br>dismissal, release, discharge, layoff
αγγίζω	αγγίζω verb<br>touch, touch on<br>border<br>offend, hurt
δημοσίευμα	δημοσίευμα noun n (plural δημοσιεύματα)<br>publication, article
χάρτης	χάρτης noun m (plural χάρτες)<br>(navigation) map, chart<br>charter, project charter, constitution
καλά	καλά adjective<br><br>καλά adverb<br>well
